3;2;8;9;1;7;5;4;6
1;4;6;5;2;3;7;8;9
7;9;5;8;6;4;3;1;2
4;8;2;3;5;1;9;6;7
6;7;9;4;8;2;1;5;3
5;3;1;7;9;6;8;2;4
9;6;3;1;4;8;2;7;5
8;5;4;2;7;9;6;3;1
2;1;7;6;3;5;4;9;8